Name,Width,Height,TilesString
Map0,8,6,"0,1,2,3,4,5,6,7,1,0,3,2,5,4,7,6,2,3,0,1,6,7,4,5,3,2,1,0,7,6,5,4,4,5,6,7,0,1,2,3,5,4,7,6,1,0,3,2"
Map1,8,6,"1,2,3,4,5,6,7,0,2,1,4,3,6,5,0,7,3,4,1,2,7,0,5,6,4,3,2,1,6,7,0,5,5,6,7,0,1,2,3,7,6,5,4,3,2,1,0,0"
Map2,8,6,"2,3,1,0,6,7,5,4,3,2,0,1,7,6,4,5,1,0,3,2,5,4,6,7,0,1,2,3,4,5,7,6,6,7,5,4,2,3,1,0,7,6,4,5,3,2,0,1"
Map3,8,6,"3,0,1,2,7,4,5,6,0,3,2,1,4,7,6,5,1,2,3,0,5,6,7,4,2,1,0,3,6,5,4,7,4,5,6,7,0,1,2,3,5,4,7,6,1,0,3,2"
Map4,8,6,"4,5,6,7,0,1,2,3,5,4,7,6,1,0,3,2,6,7,4,5,2,3,0,1,7,6,5,4,0,1,2,3,1,0,3,2,5,4,7,6,3,2,1,0,6,7,4,5"
Map7,6,5,"1,2,3,4,5,1,2,3,4,5,1,2,3,4,5,1,2,3,4,5,1,2,3,4,5,1,2,3,4,5"